111111111111111111
10000000PECCCCCCC1
100000000000000001
111111111111111111
