11111111111111111
10C0CC00100C1
10111C0100C01
1C111C00000C1
10C0E00110C01
1111CC0000001
10C0CP00100C1
1111111111111
