1111111111111
10C0CC00100C1
1111NC0100C01
11111C00000C1
11C0000110C01
1111CC0000001
10CCCP001E0C1
1111111111111
